"filename", "language", "PHP", "CSS", "comment", "blank", "total"
"c:\xampp\htdocs\Eduardo_Leandro_GerenciamentoEscalasPF\Criacao_Turnos.php", "PHP", 5, 0, 0, -1, 4
"c:\xampp\htdocs\Eduardo_Leandro_GerenciamentoEscalasPF\Criacao_TurnosFunc.php", "PHP", 26, 0, 0, 6, 32
"c:\xampp\htdocs\Eduardo_Leandro_GerenciamentoEscalasPF\Edicao_Equipe.php", "PHP", 57, 0, 0, 19, 76
"c:\xampp\htdocs\Eduardo_Leandro_GerenciamentoEscalasPF\Edicao_SelecionarTurnos.php", "PHP", 26, 0, 0, 1, 27
"c:\xampp\htdocs\Eduardo_Leandro_GerenciamentoEscalasPF\Edicao_SelecionarUsuario.php", "PHP", 56, 0, 1, 8, 65
"c:\xampp\htdocs\Eduardo_Leandro_GerenciamentoEscalasPF\Edicao_Usuario.php", "PHP", 59, 0, 0, 7, 66
"c:\xampp\htdocs\Eduardo_Leandro_GerenciamentoEscalasPF\Edicao_turno.php", "PHP", 37, 0, 0, 4, 41
"c:\xampp\htdocs\Eduardo_Leandro_GerenciamentoEscalasPF\Equipe.php", "PHP", 5, 0, 0, 3, 8
"c:\xampp\htdocs\Eduardo_Leandro_GerenciamentoEscalasPF\RegistroUsuario.php", "PHP", 13, 0, 0, 2, 15
"c:\xampp\htdocs\Eduardo_Leandro_GerenciamentoEscalasPF\css\style_Form.css", "CSS", 0, 10, 0, -1, 9
"c:\xampp\htdocs\Eduardo_Leandro_GerenciamentoEscalasPF\css\style_global.css", "CSS", 0, 3, 0, 0, 3
"c:\xampp\htdocs\Eduardo_Leandro_GerenciamentoEscalasPF\php\controller\InsertEquipe.php", "PHP", 17, 0, 0, 2, 19
"c:\xampp\htdocs\Eduardo_Leandro_GerenciamentoEscalasPF\php\controller\InsertTurnos.php", "PHP", 1, 0, 0, 0, 1
"c:\xampp\htdocs\Eduardo_Leandro_GerenciamentoEscalasPF\php\controller\Login_SenhaVerify.php", "PHP", 10, 0, 0, 2, 12
"c:\xampp\htdocs\Eduardo_Leandro_GerenciamentoEscalasPF\php\controller\UpdateEquipe.php", "PHP", 65, 0, 0, 8, 73
"c:\xampp\htdocs\Eduardo_Leandro_GerenciamentoEscalasPF\php\controller\UpdateTurno.php", "PHP", 35, 0, 0, 4, 39
"c:\xampp\htdocs\Eduardo_Leandro_GerenciamentoEscalasPF\php\controller\UpdateUsuario.php", "PHP", 68, 0, 0, 8, 76
"c:\xampp\htdocs\Eduardo_Leandro_GerenciamentoEscalasPF\php\controller\loginsession.php", "PHP", 11, 0, 0, 1, 12
"Total", "-", 491, 13, 1, 73, 578